8111111111111111111111111111111811111111111111111
8111111111111111111111111111111811111111111111111
8111111111111111111111111111111811111111111111111
8111111111111118888888888888811811111111111111111
8111111111111118111111111111111811111111111111111
8111111111111118111111111111111811111111111111111
8111111111118888888888888888888811111111111111111
8111118888888888888888888888888811111111111111111
8811111111111111111111111111111111111111111111111
8111111111111111111111111111111111111111111111111
8888111111111111111111111111111111111111111111111
8888888888888111111118888888811111111111111111111
8111111111111111111111111111111111111111111111111
8111111111111111111111111111111111111111111111111
8111111111111111888888888888888811111111111111111
8111111111111111111111111111111111111111188888888
8111111111111111111111111111111111888888888888888
8888888888888888888888888888888888888888888888888